-1 -1 -1 -1 -1 -1 -1 -1 -1 -1 -1 -1 -1
-1 -1 -1 38 39 25 -1 -1 -1 -1 -1 -1 -1
-1 -1 36 37 -1 24 -1 -1 -1 -1 -1 -1 -1
-1  1 35 -1 -1 23 -1 -1 -1 -1 -1 -1 -1
-1  2 -1 -1 -1 22 -1 -1 -1 -1 -1 -1 -1
-1  3 -1 -1 -1 21 -1 -1 33 -1 -1 34 -1
-1  4 -1 -1 -1 20 27 28 29 30 31 32 -1
-1  5 -1 -1 -1 19 -1 -1 -1 -1 -1 -1 -1
-1  6 -1 -1 -1 18 -1 -1 -1 -1 -1 -1 -1
-1  7 -1 -1 -1 17 -1 -1 -1 -1 -1 -1 -1
-1  8 -1 -1 -1 16 -1 -1 -1 -1 -1 -1 -1
-1  9 -1 -1 -1 15 -1 -1 -1 -1 -1 -1 -1
-1 10 11 12 13 14 -1 -1 -1 -1 -1 -1 -1
-1 -1 -1 -1 -1 -1 -1 -1 -1 -1 -1 -1 -1